111111111111111111111111111111
1000000P00000100000001100010C1
100000000001000000001110000001
1C0000000111100000000000000001
11000000111C000000000010000001
10W000000110000000000011000E11
111111111111111111111111111111